1111111111111111111111111111111111111111111111111111
0000000000000000000000001010101000100000000000001011
1010101011111110101110111010101011101111111010111011
1010101000000010100010100010100010000000001010001011
1110101011101111111011101110101110111011101110111011
1000101000100000001000000000000000001000100010101011
1010101111101111101011111011101110111110101111101011
1010100000100000101000001000100010000010100000000011
1011101011101011111110111111101111111110101011111111
1010001000101000000010000000100000000010101000000011
1110101010101110101011111010101011111010111010101111
1000101010100010101000001010101000001010100010100011
1010101010101110111010101111101110111011111010111011
1010101010100010001010100000100010001000001010001011
1011101010101110111010101010101011111111101010111111
1010001010100010001010101010101000000000101010001011
1010101110101010111111111010101010111011101010111011
1010100010101010000000001010101010001000101010000011
1110101110111010101011101111101010111111111011101011
1010100010001010101000100000101010000000001000101011
1011101111111010101110101011101011111010111010101111
1000000000001010100010101000101000001010001010100011
1111101011111111101110111011111011101110111110111011
1000001000001000000010001010001000100010001000001011
1111101011111111101011101110111111111110101010101111
1000001010001000001000100000000000000010101010101011
1110101010111110101011101111111011101010111010111011
1000101000000010101000100000001000101010001010000011
1010111011101111101011111110101011101111111110101011
1010100000100010001000000010101000100000001000101011
1011101010111111101111101011111110111110111110101111
1010001010000010000000101000000010000010000010100011
1011101011101010101010101010101010101011111110101011
1010001000101010101010101010101010101000000010101011
1011101010111010101110101110101110101110101011101011
1010001010001010100010100010100010100010101000101011
1010111010111011101010101011111011111110101011101011
1010100010001000101010101000001000000010101000101011
1011101010101010101110101010111011111110111011101011
1010001010101010100010101010001000000010001000101011
1011101010101011101011101010111010111111111011111111
1000101010101000101000101010001010000000101000000011
1010111010101011101011111010111111111111101111111111
1010001010101000101000001010000010001010000000000011
1011101110101010111011101011111110111010111110111011
1000101000101010001000101000000000000000000010001011
1010111110111010111011101110111110101110101011111111
1010100010001010001010000010000010100010101010000011
1011101110111110111011101111111011111011101110111111
1000000010001000001000100000001000001010000000000011
1110111111111110111111111111111111111011111111111000
1111111111111111111111111111111111111111111111111111